NO ./img/texture/tileable7e.png
WE ./img/texture/trak_panel_lrg8.png
SO ./img/texture/cabin_chimney_side.png
EA ./img/texture/rockfloorbig.png
F 0,122,0
C 0,32,122
11111111111111         11111111111111
10000000000001         10000000000001
1000000000000111111111110000000000001
1000000000000000000000000000000000001
1000000000000000000000000000000000001
1000000000000111100001110000000000001
1000000000000000000000000000000000001
1000000000000000000000000000000000001
1111111111111111000000111111111111111
               10000001
1111111111111111000000111111111111111
1000000000000000000000000000000000001
1000000000000000000000000000000000001
100000000000000000E000000000000000001
1000000000000000000000000000000000001
1000000000000000000000000000000000001
1111111111111111111111111111111111111