NO ./assets/textures/1_no.xpm
SO ./assets/textures/1_so.xpm
WE ./assets/textures/1_we.xpm
EA ./assets/textures/1_ea.xpm
F 0,122,122
C 0,0,0
11111111111111
10000000000001
11111111111111
10001111000001
10001111000001
11111111111111