NO ./img/texture/fern_north.png
EA ./img/texture/fern_east.png
SO ./img/texture/fern_south.png
WE ./img/texture/fern_west.png
F 0,127,0
C 130,202,255

11111111111111111111
10000000000000000001
10010101010101010101
10000000000000000001
10010101010101010101
10000000000000000001
100000000E0000000001
10000000000000000001
10010101010101010101
10000000000000000001
10010101010101010101
10000000000000000001
11111111111111111111
