NO ./assets/textures/1_no.png
SO ./assets/textures/1_so.png
WE ./assets/textures/1_we.png
EA ./assets/textures/1_ea.png
F 0,122,122
C 0,0,0
11111111111111111111
10000000000000000001
10010101010101010101
10000000000000000001
10010101010101010101
10000000000000000001
100000000S0000000001
10000000000000000001
10010101010101010101
10000000000000000001
10010101010101010101
10000000000000000001
11111111111111111111